1111111111111111111111111111111111
10S0000CC000C0010000010000S0000001
101001010000C0001010010C0C00010101
101001C010101010001001000000010101
1PCCC0000100100000C00000C000000E11
1111111111111111111111111111111111