1111111111111111111111111111111111
1000000CC000C001000001000000000001
101001010000C0001010010C0C00010101
101001C010101010001001000000010101
1PCCC0000100100000C00000C000000E11
1111111111111111111111111111111111