1111111111111111111111111111111111
1000000C0000C0010000010000C0000001
101001010010000010100100CCC0010101
101001C010101010001001000000010101
1PCCC0000100100000000000C000000E11
1111111111111111111111111111111111