1111111111111111111111111111111111
100000000000C0010000010000C0000001
1010010100100000101001000000010101
101001C010101010001001000000010101
1P0000000100100000000000C000000E11
1111111111111111111111111111111111