11111111111111111111
10000000011000000001
10110111000011101101
10000000000000000001
10110101111110101101
10000100011000100001
11110111011011101111
11110100000000101111
1P000001100110000001
11110101000010101111
11110101111110101111
10000000000000000001
10110110111101101101
10010000000000001001
11010101111110101011
10000100011000100001
10111110011001111101
10000000000000000001
11111111111111111111