1111111111111
111111P000001
1111110EC1111
1111111111111