11111111111111111111
1000010C01C000S0CC11
1P000101011111000111
100000010C00000000E1
11111111111111111111