1111111111111111111111111111111111
100001010000C0001010010C1C00010101
101001C000101010001000001000010101
1P0000000100100000C00000C000000E11
1111111111111111111111111111111111