11111111111111111111
1CCCC0000110000CCCC1
1C1101110000111C11C1
1CCCC0000000000CCCC1
10110101111110101101
1000C1000110001C0001
11110111011011101111
1111C1000000001C1111
1P0000011001100000E1
1111C101SSSS101C1111
11110101100110101111
1CCCC0000000000CCCC1
1C11C1101111011C11C1
1CC1C0000000000C1CC1
11C1C1011111101C1C11
1CCCC1000110001CCCC1
1C1111100110011111C1
1C0C0C0C0CC0C0C0C0C1
11111111111111111111