1111111111111
1000000000001
10001S0000001
1000010000001
1111111111111

1 up
2 down
3 left
4 right
5 up down
6 up left
7 up right
8 up down left
9 up down right
10 up left right
11 down left
12 down right
13 down left right
14 left right

it doesnt matter you have one or more enemy , the leaks are still same amount