11111111111111111111
1P000000E000C0000011
100000000000C0000011
11111111111111111111